宜人财富	财经
人人贷理财	财经
和信贷理财	财经
宜人贷借款	财经
PPmoney理财	财经
新浪财经	财经
Tiger Trade老虎证券	财经
牛股王股票	财经
51信用卡管家	财经
富途牛牛	财经
国泰君安君弘	财经
优品股票通	财经
股票灯塔	财经
拍拍贷财富	财经
平安证券	财经
腾讯自选股	财经
爱钱进	财经
挖财信用卡管家	财经
广发易淘金	财经
掌证宝股票炒股开户	财经
雪球股票	财经
钠镁股票	财经
选股宝	财经
融360	财经
向日葵保险	财经
杭银金融	财经
现金超人	财经
零用贷财富	财经
盈宽期货	财经
花生米富	财经
平安金管家	财经
呼呼省钱	财经
网易有钱记账	财经
聚保汇	财经
多赚	财经
中国建设银行	财经
中国工商银行	财经
农行掌上银行	财经
中国银行手机银行	财经
同花顺	财经
邮储手机银行	财经
招商银行	财经
掌上生活	财经
交通银行	财经
网易彩票	财经
六合彩宝典	财经
牛股王	财经
QQ财付通	财经
大智慧	财经
益盟操盘手经典版	财经
民生银行手机银行	财经
工银融e联	财经
度小满股市通	财经
平安普惠	财经
随手记	财经
广发银行手机银行	财经
浦发手机银行	财经
东方财富	财经
福建农信	财经
兴业银行手机银行	财经
光大银行手机银行	财经
京东金融	财经
钱宝	财经
京东钱包	财经
中信银行手机银行	财经
500彩票	财经
天天基金	财经
工商银行通用U盾	财经
蚂蚁财富	财经
广发手机证券至强版	财经
浙江农信手机银行	财经
盈盈理财	财经
涨乐财富通	财经
QQ彩票	财经
陆金所	财经
约彩365	财经
米赚	财经
手机证券	财经
挖财记账	财经
唯彩看球	财经
平安壹钱包	财经
六合彩助手	财经
中国银河证券	财经
大公鸡七星彩	财经
银联安全支付助手	财经
福利彩票	财经
招商智远理财	财经
保险师	财经
闪银	财经
秒赚	财经
顺丰金融	财经
捷信金融	财经
双色球之家	财经
银联手机支付	财经
股票雷达	财经
平安口袋财务	财经
江苏农信手机银行	财经
中信证券高端版	财经
同花顺炒股票	财经
广发银行	财经
兴业银行	财经
财付通	财经
浙江农信	财经
用钱宝	财经
浦发银行	财经
民生银行	财经
钱包	财经
中国银行	财经
信用管家	财经
江苏银行	财经
光大银行	财经
中信银行	财经
壹钱包	财经
邮储银行	财经
双色球	财经
福利彩票一定牛	财经
安全支付	财经
六合宝典	财经
安全支付助手	财经
双色球开奖结果	财经
信用管家借钱	财经
双色球-专业版	财经
农银e管家	财经
信用钱包	财经
卡牛信用管家	财经
福彩双色球彩票	财经
和包安全支付插件	财经
全民双色球	财经
和包	财经
和包支付	财经
金融超市	财经
云南农信	财经
中国农业银行	财经
钱盾	财经
天天中彩票	财经
网商银行	财经
平安口袋银行	财经
来分期	财经
浦发信用卡	财经
中信证券	财经
安信手机证券	财经
工银e生活	财经
四川农信	财经
广银信用卡	财经
e钱庄	财经
银联可信服务安全组件	财经
悟空理财	财经
国寿e宝	财经
重庆农商行	财经
企业手机银行	财经
财产系统	财经
建行企业银行	财经
微众银行	财经
太平洋寿险	财经
直销银行	财经
北京银行	财经
农行企业掌银	财经
速贷	财经 
团贷网	财经 
榕树贷款	财经 
小黑鱼	财经 
向钱贷	财经 
菠萝贷	财经 
速贷借呗现金贷款	财经 
及贷	财经 
闪贷借款	财经 
极速现金侠	财经 
借贷宝	财经 
快贷	财经 
融360贷款	财经 
我来贷	财经 
借钱花	财经 
好贷	财经 
人人贷借款	财经 
极贷管家	财经 
360借条	财经 
360借条分期贷款	财经 
给你花	财经 
黔农e贷	财经 
买单侠	财经 
买单侠分期	财经 
快视频	电影
人人视频	电影
PP视频播放器	电影
火山小视频	电影
搜狐视频HD	电影
华为视频	电影
凤凰视频HD	电影
爱奇艺	电影
凤凰视频	电影
腾讯视频	电影
优酷	电影
爱奇艺纳逗	电影
爱奇艺动画屋	电影
爱奇艺HD	电影
视频播放	电影
搜狐视频	电影
腾讯视频小米版	电影
快影	电影
爱奇艺视频	电影
爱奇艺播放器	电影
优酷视频	电影
视频播放器	电影
百度视频	电影
视频?优酷版	电影
爱奇艺PPS	电影
手机电视直播大全	电影
小米视频追剧助手	电影
三星视频	电影
小米搜狐视频播放器插件	电影
沃视频	电影
聚力视频	电影
天翼视讯电视直播	电影
土豆视频	电影
乐视视频	电影
视频组件包	电影
沃家视频	电影
视频解码器	电影
天翼视讯直播视频播放器	电影
好看视频	电影
萤石云视频	电影
演示视频	电影
看点视频	电影
咪咕视频和4G版	电影
视频看看	电影
超级视频	电影
手机电视高清直播	电影
风行视频	电影
手机电视	电影
天翼视讯	电影
土豆	电影
云图手机电视	电影
云图高清手机电视	电影
影视大全	电影
咪咕影院	电影
哔哩哔哩	电影
央视影音	电影
芒果TV	电影
火萤	电影
暴风影音	电影
影音先锋	电影
PP视频	电影
360影视大全	电影
火萤组件	电影
YouTube	电影
KM影视大全	电影
Google Play 电影	电影
爱奇艺VR	电影
快视频看片	电影
小米风行播放插件	电影
1905电影网	电影
电视派	电影
Koznak	电影
内涵段子	搞笑
糗事百科	搞笑
逗客	搞笑
人体穴位图解	健康
北京协和医院	健康
康爱多掌上药店	健康
叮当快药	健康
乐动力	健康
健康160挂号问诊	健康
丁香医生	健康
平安健康	健康
康康在线	健康
运动健康	健康
春雨医生	健康
春雨计步器	健康
Keep	健康
咕咚	健康
平安好医生	健康
减肥瘦身大全	健康
悦动圈	健康
小米运动	健康
每日瑜伽	健康
悦跑圈	健康
医院	健康
丁香家庭医生	健康
薄荷健康	健康
1药网	健康
火辣健身	健康
老偏方	健康
Abs锻炼计划	健康
计步器	健康
日历	健康
联想日历	健康
三星健康	健康
运动	健康
天气日历	健康
微脉	健康
初中知识点大全	教育
科目二模拟驾驶学车	教育
洋葱数学	教育
作业大师	教育
乐教乐学	教育
作业帮	教育
p图修图PS神器	教育
钢琴教练	教育
汉语字典专业版	教育
百度翻译	教育
TED演讲	教育
建筑移动课堂	教育
DaDa英语	教育
小站托福	教育
小站雅思	教育
沪江网校	教育
脱口派	教育
听语教学	教育
鲸小爱英语	教育
经典导读	教育
免费吉他谱	教育
网易有道词典探索版	教育
学霸君	教育
沪江开心词场	教育
艾教育	教育
网易有道词典	教育
词典翻译金山词霸	教育
百词斩	教育
英语流利说	教育
猿题库	教育
一起作业学生	教育
纳米盒	教育
Google翻译	教育
汉语字典和汉语成语词典	教育
有道翻译官	教育
英语趣配音	教育
新概念英语语音同步版	教育
新编字典	教育
我要当学霸	教育
阿凡题搜题	教育
作业神器	教育
每日英语听力	教育
作业通	教育
美国外教口语每日必听8000句	教育
网易公开课	教育
英汉字典/汉英字典EnglishDictionary	教育
英语翻译	教育
微课掌上通	教育
学习韩语	教育
扇贝单词	教育
PS自学手册	教育
学外语	教育
课程格子	教育
学英文:常用英语会话，美国和英国旅游必备	教育
有道词典	教育
BOXFiSH盒子鱼英语	教育
作业盒子小学学生端	教育
我爱画画	教育
出国翻译官	教育
英语口语7天乐	教育
粤语通	教育
金山背单词	教育
英语随身学	教育
翻译	教育
成语词典	教育
汉语字典	教育
字典	教育
作业盒子小学	教育
金山词霸	教育
新华字典发音版	教育
腾讯翻译君	教育
新华字典	教育
快快查汉语字典	教育
金立翻译	教育
安全教育平台	教育
可可英语	教育
简书	教育
超级课程表	教育
口语100	教育
古诗词典	教育
爱上安全	教育
智行火车票	旅游
途歌TOGO	旅游
搜狗地图	旅游
Bus365汽车票	旅游
烽鸟共享汽车	旅游
谷雨	旅游
全球卫星地图	旅游
快票出行	旅游
三毛游	旅游
爱自驾	旅游
约伴去旅行	旅游
八达行	旅游
秦皇岛园博园	旅游
飞猪商家版	旅游
Eatwith	旅游
亚朵	旅游
周末去哪儿	旅游
多多指南针	旅游
口袋澳门	旅游
南方航空	旅游
同程旅游	旅游
携程旅行	旅游
艺龙旅行	旅游
驴妈妈旅游	旅游
高德地图	旅游
百度地图	旅游
去哪儿旅行	旅游
马蜂窝旅游	旅游
途牛旅游	旅游
途家	旅游
皇包车旅行	旅游
艺龙酒店	旅游
iGola骑鹅旅行	旅游
春秋航空	旅游
Airbnb爱彼迎	旅游
Booking.com	旅游
绿驰出行	旅游
陶都出行	旅游
凯思盾出行	旅游
铁路12306	旅游
凯立德导航	旅游
优步，伴您轻松海外行	旅游
百度导航	旅游
高铁管家	旅游
飞猪旅行	旅游
导航犬	旅游
腾讯地图	旅游
铁友火车票	旅游
悠悠导航	旅游
智行火车票for12306火车票官网	旅游
GPS电子狗	旅游
火车票达人	旅游
12306抢票助手	旅游
图吧导航一号	旅游
Google地图	旅游
盛名列车时刻表	旅游
订票助手	旅游
航班管家	旅游
买火车票for12306火车票官网	旅游
在路上	旅游
路路通时刻表	旅游
酷讯机票	旅游
航旅纵横	旅游
蚂蜂窝自由行HD	旅游
凯立德导航伴侣	旅游
途牛旅游HD	旅游
神州租车	旅游
抢票助手for12306	旅游
坐车网	旅游
离线地图和GPS导航仪	旅游
飞常准	旅游
首旅如家	旅游
导航犬离线版	旅游
卫星地图	旅游
路路通	旅游
指南针	旅游
爱彼迎	旅游
盛名时刻表	旅游
飞猪	旅游
智行火车票12306高铁抢票	旅游
易到	旅游
铁友火车票12306抢票	旅游
智行火车票12306购票	旅游
艺龙旅行-酒店机票	旅游
搜狗地图MINI版	旅游
图吧导航	旅游
高铁管家12306火车票	旅游
地图	旅游
高德地图—intel定制版	旅游
和地图	旅游
地图应用	旅游
奥维互动地图	旅游
高德导航	旅游
12306智行火车票	旅游
智行火车票12306抢票	旅游
蚂蜂窝自由行	旅游
天际通	旅游
行者	旅游
天际通数据服务	旅游
12306汽车票	旅游
diditaxi://	旅游
阿里旅行	旅游
PonyCar	旅游
高德地圖	旅游
往返	旅游
更美医生版	美容
蜜芽宝贝	母婴育儿
婴儿辅食食谱	母婴育儿
妈妈网孕育	母婴育儿
柚宝宝孕育	母婴育儿
孕期伴侣	母婴育儿
宝宝医院-宝宝学习	母婴育儿
宝宝学配对-拼图世界	母婴育儿
宝宝宇航员	母婴育儿
宝宝学儿歌	母婴育儿
宝宝爱吃饭-宝宝巴士	母婴育儿
我的小公主城堡	母婴育儿
毛绒宠物美容院	母婴育儿
恐龙汽车	母婴育儿
宝宝出行安全	母婴育儿
宝宝迷宫大冒险-宝宝巴士	母婴育儿
宝宝梦幻冰淇淋	母婴育儿
宝宝钓鱼-宝宝巴士	母婴育儿
起名取名字大师	母婴育儿
小伴龙	母婴育儿
宝宝树孕育	母婴育儿
辣妈帮	母婴育儿
妈妈网轻聊	母婴育儿
妈妈帮	母婴育儿
贝瓦儿歌	母婴育儿
宝宝幼儿园	母婴育儿
宝宝学唱儿歌2	母婴育儿
宝宝巴士大全	母婴育儿
孕期提醒	母婴育儿
每日必听故事	母婴育儿
宝宝画妈妈猜ー宝宝巴士	母婴育儿
家长通	母婴育儿
照顾小宝宝	母婴育儿
儿童世界	母婴育儿
幼儿识字	母婴育儿
亲宝宝	母婴育儿
宝宝知道	母婴育儿
宝宝数学训练	母婴育儿
宝贝晚安故事	母婴育儿
宝宝树小时光	母婴育儿
宝贝听听	母婴育儿
宝宝沙滩乐	母婴育儿
宝宝学汉字	母婴育儿
宝宝小船长	母婴育儿
宝宝学语文	母婴育儿
动卡空间	母婴育儿
儿童睡前小故事【有声版】	母婴育儿
宝宝美食街	母婴育儿
经典儿歌	母婴育儿
宝宝学数学2	母婴育儿
宝宝学蔬菜：宝宝巴士	母婴育儿
宝宝巴士	母婴育儿
柚宝宝	母婴育儿
宝宝幼儿园-宝宝巴士	母婴育儿
宝宝游乐园-宝宝巴士	母婴育儿
中华美食-宝宝巴士	母婴育儿
宝宝星际厨房-宝宝巴士	母婴育儿
宝宝超市-宝宝巴士	母婴育儿
装扮小公主-宝宝巴士	母婴育儿
奇妙农场-宝宝巴士	母婴育儿
宝宝巴士儿歌	母婴育儿
宝宝巴士奇妙屋	母婴育儿
雪糕工厂-宝宝巴士	母婴育儿
宝宝超市	母婴育儿
宝宝神奇汽车	母婴育儿
小豆苗疫苗助手	母婴育儿
宝宝梦想小镇	母婴育儿
儿童模式	母婴育儿
家长帮	母婴育儿
智天使2	母婴育儿
儿歌多多	母婴育儿
小猿口算	母婴育儿
广东和教育	母婴育儿
小猿搜题	母婴育儿
安全守护	母婴育儿
掌上电力	母婴育儿
宝宝医院-宝宝巴士	母婴育儿
宝宝果汁商店	母婴育儿
大姨妈	女性
西柚大姨妈	女性
美丽修行	女性
更美	女性
排卵期安全期日历	女性
就爱广场舞	女性
美柚月经期助手	女性
美柚	女性
驾照考试	汽车
小熊油耗	汽车
睿米智能生活	汽车
车鉴定	汽车
车商城	汽车
车险比价报价	汽车
汽车报价	汽车
一汽大众服务	汽车
淘车二手车	汽车
警视通	汽车
凯励程	汽车
ETC车宝	汽车
懂车帝	汽车
优信二手车	汽车
乐车邦	汽车
途虎养车	汽车
毛豆新车	汽车
首汽约车	汽车
易车	汽车
帅车	汽车
车米会	汽车
车小主云库	汽车
越野助手	汽车
驾本易教练	汽车
汽配神器	汽车
51车商家	汽车
爱车主	汽车
学车不	汽车
驾考宝典	汽车
驾校一点通	汽车
车轮驾考通	汽车
驾考宝典免费版HD	汽车
元贝驾考	汽车
驾照理论	汽车
淘车	汽车
人人车二手车	汽车
驾考宝典科目一	汽车
汽车报价大全	汽车
车轮驾考通驾照考试宝典	汽车
汽车报价之家	汽车
驾校一点通科目四	汽车
驾考宝典科目四	汽车
车轮	汽车
途虎养车-汽车保养	汽车
买车宝典-汽车报价	汽车
驾校一点通科目一	汽车
汽车报价-低价淘车	汽车
人人车	汽车
汽车大全	汽车
车轮查违章	汽车
车轮社区	汽车
车轮全国违章查询	汽车
买车宝典	汽车
汽车之家	汽车
全国违章查询	汽车
违章查询-汽车之家	汽车
查违章	汽车
违章查询	汽车
微车违章查询	汽车
违章查询12123	汽车
违章查询助手	汽车
车行易查违章	汽车
车主无忧违章查询	汽车
汽车违章查询	汽车
车主无忧	汽车
平安好车主	汽车
瓜子二手车	汽车
二手车之家	汽车
车轮违章查询	汽车
车轮查违章全国违章查询	汽车
交警在线	汽车
北京交警	汽车
汽车头条	汽车
弹个车	汽车
壹学车	汽车
车源宝	汽车
宜停车	汽车
菱菱邦	汽车
卡车之家	汽车
超车小能手	汽车
贵州石油	汽车
无忧乐行	汽车
大风车	汽车
米车生活	汽车
车销通	汽车
义乌购	生活
我有券	生活
蜜源	生活
十色成人两性用品	生活
华为商城	生活
粉象生活	生活
中国邮政	生活
红人装	生活
卷皮折扣	生活
花小钱	生活
拼多多	生活
蘑菇街	生活
1号店	生活
闲鱼	生活
小红书	生活
唯品会	生活
手机淘宝	生活
寺库奢侈品	生活
京东	生活
苏宁易购	生活
每日优鲜	生活
当当	生活
酒仙网	生活
SEPHORA	生活
万表名表商城	生活
舒华	生活
达达	生活
小米有品	生活
网易严选	生活
什么值得买	生活
齐家	生活
屈臣氏莴笋	生活
网易考拉	生活
开心芝麻	生活
喵喵折	生活
快拍买家版	生活
家佳购	生活
贝贝	生活
买单吧	生活
百度手机助手(手机淘宝)	生活
达达骑士版	生活
手机京东	生活
卷皮折扣－天天特价	生活
京东到家	生活
网易考拉海购	生活
天猫	生活
闪电降价	生活
手机天猫	生活
一亩田	生活
折800	生活
返利	生活
转转	生活
聚美优品	生活
购物中心	生活
省钱快报	生活
阿里巴巴	生活
帮购	生活
小米商城	生活
MM商场	生活
米家有品	生活
国美	生活
购物大厅	生活
360商城	生活
WANTS好物	生活
醒购	生活
惠比价	生活
一淘	生活
虹领巾	生活
花生日记	生活
拍拍二手	生活
小象优品	生活
乐视商城	生活
享骑电单车	生活
易公交	生活
滴滴出行	生活
快的打车	生活
掌上公交	生活
8684公交	生活
车来了	生活
神州专车	生活
e代驾	生活
公交地铁查询	生活
嘀嗒拼车	生活
嘀嗒出行	生活
一号专车	生活
美团打车	生活
连尚WiFi地图	生活
哈罗单车	生活
滴滴顺风车	生活
摩拜单车	生活
ofo共享单车	生活
顺风车	生活
深圳地铁	生活
花生地铁	生活
酷骑单车	生活
易到车主端	生活
WPS Office	生活
打卡	生活
西安交警-警用版	生活
打卡助手	生活
WPSOffice	生活
滴滴司机	生活
滴滴车主	生活
Office办公助手	生活
MicrosoftWord	生活
MicrosoftExcel	生活
印象笔记	生活
千牛	生活
店长直聘	生活
有道云笔记	生活
纷享销客	生活
微任务赚钱	生活
我的打工网	生活
找到	生活
一本日记	生活
移动经纪人	生活
行业找工作	生活
智联卓聘求职	生活
Webex Meet	生活
笔记	生活
美团骑手	生活
找到丨找人脉找客户	生活
云笔记	生活
美团外卖商家版	生活
拼多多商家版	生活
企业微信	生活
美团开店宝	生活
三星笔记	生活
微商相册	生活
货车帮司机	生活
前程无忧51Job	生活
拉卡拉收款宝	生活
钉钉	生活
黄页	生活
脉脉	生活
智联招聘	生活
名片全能王	生活
CAD手机看图	生活
CAD快速看图	生活
饿了么商家版	生活
Excel	生活
Word	生活
Microsoft Excel	生活
Microsoft Word	生活
掌柜宝	生活
盒伙人	生活
PowerPoint	生活
Microsoft PowerPoint	生活
立刷	生活
瑞和宝	生活
国务院	生活
船讯网	生活
中央纪委网站	生活
简报	生活
领英	生活
骑士助手	生活
运满满司机	生活
嘀嗒出租司机	生活
3G网络电话	生活
微信	生活
QQ	生活
人人	生活
影缘	生活
爱族群	生活
甜甜语音	生活
1号社交	生活
同城陌恋爱约	生活
甜心交友	生活
QQ邮箱	生活
半次元	生活
钓鱼人	生活
云岭先锋	生活
微博	生活
贴吧极速版	生活
微信双开2	生活
佳人有约同城约会	生活
豆瓣	生活
Messenger	生活
陪我	生活
谁是卧底	生活
微信双开	生活
人人中彩票	生活
微信自动抢红包	生活
微信2	生活
微信分身	生活
百度手机助手(微信)	生活
电话	生活
百度手机助手(QQ)	生活
腾讯微博	生活
微信电话本	生活
双开助手(微信多开分身版)	生活
微信支付安全插件（百度）	生活
微信双开助手	生活
微信1	生活
微信多开助手	生活
双开助手(微信多开分身)	生活
微博极速版	生活
微信A	生活
微信分身版	生活
双开助手	生活
微微电话	生活
触宝电话	生活
多开分身	生活
视频电话	生活
双开助手(多开分身)	生活
多开助手	生活
米聊	生活
连信	生活
探探	生活
派派	生活
美篇	生活
分身大师	生活
QQ同步助手	生活
QQ空间	生活
QQ安全中心	生活
OPPO社区	生活
MOMO陌陌	生活
QQ轻聊版	生活
双开助手微信多开分身版	生活
QQ国际版	生活
双开助手多开分身版	生活
360社区	生活
密友圈	生活
和家亲	生活
108社区	生活
乐嗨秀场	生活
货拉拉	生活
无线锦州	生活
麦当劳麦乐送	生活
美食大全	生活
早餐	生活
悟空外卖	生活
馨小厨	生活
YHOUSE	生活
煲汤食谱	生活
酒咔嚓	生活
肯德基	生活
食谱大全	生活
联掌门户	生活
闪电虎	生活
贝壳找房	生活
青客公寓	生活
天气王-天气预报	生活
红星美凯龙	生活
房多多	生活
门禁卡	生活
中燃慧生活	生活
合发	生活
老黄历万年历	生活
娱票儿	生活
华为钱包	生活
支付宝	生活
美团	生活
51公积金管家	生活
美团外卖	生活
好好住	生活
安居客	生活
乐有家房源网	生活
有看头	生活
快递蜂达达	生活
2345天气预报	生活
菜城配送	生活
美的i+	生活
华为生活服务	生活
智能家居	生活
百度糯米	生活
小厨房	生活
美团众包	生活
货拉拉-搬家拉货	生活
支付宝快捷支付服务	生活
百度手机助手(支付宝)	生活
黄历	生活
天气预报	生活
生活服务	生活
钱包	生活
天气	生活
支付宝安全校验服务	生活
货拉拉-拉货搬家	生活
华为钱包安全支付	生活
天气王	生活
百度外卖	生活
老黄历万年历顺历日历	生活
百度外卖-美食品质外卖	生活
美团打车司机	生活
百度外卖-美食团购支付	生活
货拉拉司机版	生活
万年历	生活
中华老黄历	生活
盛钱包成长版	生活
小米钱包	生活
中华万年历-日历天气	生活
天气服务	生活
订阅日历	生活
中国天气通	生活
好运万年历	生活
中华万年历日历天气	生活
中华万年历日历	生活
小花钱包	生活
佰仟买买钱包	生活
好运天气	生活
快钱钱包	生活
万年历黄历	生活
天气通	生活
中邮钱包	生活
盛迪嘉钱包	生活
天气存储	生活
华为支付	生活
天气主题	生活
彩云天气	生活
沃钱包	生活
黄历天气	生活
中央天气预报	生活
金立钱包	生活
最美天气	生活
万年历日历	生活
本地天气预报	生活
墨迹天气	生活
中华万年历	生活
万年历日历黄历	生活
风水罗盘安居指南针	生活
四川移动掌上营业厅	生活
菜鸟裹裹	生活
口碑	生活
掌通家园	生活
广西移动	生活
云南移动	生活
手机营业厅	生活
支付中心（系统软件）	生活
赶集网	生活
贵州交警	生活
电信营业厅	生活
下厨房	生活
米家	生活
山东移动	生活
翼支付	生活
社保掌上通	生活
中国移动	生活
云闪付	生活
和聚汇	生活
广东移动	生活
大众点评	生活
掌上营业厅	生活
浙江移动手机营业厅	生活
阳光惠生活	生活
饿了么	生活
Google 日历同步	生活
Google日历同步	生活
15日天气预报	生活
2345天气王	生活
10086	生活
58同城	生活
支付中心	生活
365日历-万年历	生活
房贷计算器	生活
云付	生活
天气日历	生活
米家授权	生活
翼支付收银台	生活
口碑掌柜	生活
百姓网	生活
和悦会	生活
房天下	生活
形色	生活
小爱语音引擎	生活
河北移动	生活
房天下一新房二手房租房买房搜房房价	生活
美食烹饪家	生活
淘票票	生活
恒房通	生活
公交卡	生活
微记账	生活
多点	生活
婚礼纪-结婚必备	生活
智能识物	生活
永辉生活	生活
富友收件宝	生活
香哈菜谱	生活
链家	生活
华为穿戴	时尚
腾讯体育	体育
新浪体育	体育
乐视体育	体育
YouTube 音乐	音乐
虾米音乐	音乐
音乐	音乐
百度手机助手(酷狗音乐)	音乐
网易云音乐	音乐
多米音乐	音乐
酷狗音乐	音乐
三星音乐	音乐
酷我音乐-歌手2017	音乐
百度音乐	音乐
酷我音乐HD	音乐
酷我音乐	音乐
咪咕音乐	音乐
i 音乐	音乐
YY-金立音乐版	音乐
QQ音乐	音乐
Google Play 音乐	音乐
QQ影音	音乐
爱音乐	音乐
音乐播放器	音乐
华为游戏中心	游戏
随身炉石传说	游戏
不朽凡人	游戏
大天使之剑H5	游戏
屠龙破晓	游戏
仙灵觉醒	游戏
青云诀	游戏
海洋奏歌	游戏
灵灵聊天女仆	游戏
疯狂升级	游戏
雷电2016	游戏
灵剑传说	游戏
绝地兽人	游戏
羽毛球高高手	游戏
跳跳跳方块	游戏
天天爱钓鱼	游戏
山海异闻录	游戏
泡泡	游戏
穿越火线：枪战王者	游戏
三国罗曼史	游戏
奇异狗	游戏
奥特曼格斗之热血英雄	游戏
游视界	游戏
王者荣耀	游戏
开心消消乐	游戏
地铁跑酷	游戏
贪吃蛇大作战	游戏
迷你世界	游戏
宾果消消消	游戏
绝地求生 刺激战场	游戏
神庙逃亡2	游戏
植物大战僵尸2	游戏
汤姆猫跑酷	游戏
开心消消乐?	游戏
游戏	游戏
快手小游戏	游戏
宾果消消消?	游戏
贪吃蛇大战	游戏
爱奇艺斗地主	游戏
泡泡精灵传奇	游戏
游戏中心	游戏
贪吃蛇大作战?	游戏
地铁跑酷(OPPO定制)	游戏
植物大战僵尸2高清版	游戏
升级	游戏
宾果消消消?（OPPO定制）	游戏
王者荣耀助手	游戏
狐狸游戏	游戏
游戏大厅	游戏
鱼丸游戏	游戏
系统升级	游戏
游戏中心剑侠世界2主题包	游戏
多乐升级	游戏
游戏蜂窝	游戏
游戏工具	游戏
腾讯游戏助手	游戏
欢乐升级	游戏
游戏服务	游戏
咪咕游戏	游戏
悟饭游戏厅	游戏
游戏加速器	游戏
柠檬游戏	游戏
同桌游戏	游戏
无线升级	游戏
小米游戏中心福利助手	游戏
游戏盒子	游戏
魅族游戏框架	游戏
啪啪游戏厅	游戏
最囧游戏2	游戏
单机斗地主	游戏
天天斗地主（真人版）	游戏
腾讯桌球	游戏
企鹅电竞	游戏
荒野行动	游戏
钢琴块2	游戏
球球大作战	游戏
欢乐麻将	游戏
天天爱消除	游戏
天天象棋	游戏
掌上英雄联盟	游戏
微乐贵阳捉鸡	游戏
微乐捉鸡麻将	游戏
我的汤姆猫	游戏
中国象棋	游戏
竖屏斗地主	游戏
腾讯欢乐麻将	游戏
博雅中国象棋	游戏
波克捕鱼	游戏
欢喜斗地主	游戏
绝地求生 全军出击	游戏
我的安吉拉	游戏
熊猫四川麻将	游戏
天天酷跑	游戏
我的世界	游戏
欢乐斗地主	游戏
QQ飞车	游戏
JJ斗地主	游戏
QQ游戏	游戏
单机斗地主（欢乐版）	游戏
4399游戏盒	游戏
象棋	游戏
Google Play 游戏	游戏
欢乐斗地主（最新版）	游戏
网易手游管家	游戏
欢乐斗地主超强版	游戏
开心游戏	游戏
多玩我的世界盒子	游戏
途游中国象棋	游戏
360游戏大厅	游戏
7723游戏盒	游戏
EUI游戏支付	游戏
OPPO小游戏	游戏
象棋高手	游戏
欢乐切水果大作战	游戏
闲来麻将	游戏
保卫萝卜	游戏
保卫萝卜2	游戏
?游戏超人	游戏
四川麻将（血战到底）	游戏
麻友圈2	游戏
天天炫斗	游戏
部落冲突	游戏
掌上飞车	游戏
掌上道聚城	游戏
小鸡模拟器	游戏
闲来广东麻将	游戏
葫芦侠	游戏
彩神争霸	游戏
三国战纪	游戏
奥特曼正义降临	游戏
开心跳一跳	游戏
第五人格	游戏
奥特曼传说之战	游戏
奇妙逻辑冒险	游戏
啪啪PSP插件	游戏
满贯捕鱼	游戏
怪兽消消消	游戏
欢乐四川麻将3D版	游戏
多乐贵阳捉鸡麻将	游戏
捕鱼达人3	游戏
拳皇97OL	游戏
兴趣部落	游戏
弓箭手大作战	游戏
跳舞的线	游戏
诛仙	游戏
叶罗丽精灵梦	游戏
火线精英	游戏
网喵	游戏
阴阳师	游戏
波克棋牌	游戏
麻友圈安全版	游戏
极品芝麻官	游戏
麻将来了	游戏
我叫MT4	游戏
爆裂抓娃娃	游戏
西瓜视频	娱乐
快看影视	娱乐
微信视频	娱乐
红包快手	娱乐
快手看片	娱乐
纳逗	娱乐
YY	娱乐
微信读书	娱乐
快手	娱乐
么么直播	娱乐
唱吧	娱乐
天天爱看	娱乐
喵特	娱乐
荣耀阅读	娱乐
快看免费小说书城	娱乐
晋江小说阅读	娱乐
免费漫画	娱乐
起点读书	娱乐
免费看漫画大全	娱乐
抖音短视频	娱乐
爱奇艺阅读	娱乐
芝士超人	娱乐
最右	娱乐
酷狗直播	娱乐
腾讯NOW直播	娱乐
喜马拉雅FM	娱乐
九秀直播	娱乐
花椒直播	娱乐
TT语音	娱乐
六间房秀场	娱乐
石榴直播	娱乐
映客直播	娱乐
梨视频	娱乐
看小说阅读器txt免费全本电子书	娱乐
刺猬猫阅读	娱乐
华为阅读	娱乐
百度阅读	娱乐
书城	娱乐
微博动漫	娱乐
读书	娱乐
免费小说	娱乐
免费电子书	娱乐
快看小说	娱乐
喜马拉雅FM-听书电台	娱乐
花椒	娱乐
天天看	娱乐
爱看	娱乐
六间房秀场-视频直播	娱乐
直播	娱乐
电子书	娱乐
视频	娱乐
阅读	娱乐
快手直播伴侣	娱乐
百度贴吧	娱乐
看漫画	娱乐
爱阅读	娱乐
猫咪视频	娱乐
企鹅直播	娱乐
道客阅读	娱乐
免费小说书集	娱乐
八闽视频	娱乐
熊猫直播	娱乐
搜狐新闻曲屏版	娱乐
全本免费阅读器	娱乐
鲸鱼阅读	娱乐
直播助手	娱乐
星光直播	娱乐
央视新闻	娱乐
搜狗阅读	娱乐
全本免费阅读书城	娱乐
小米直播	娱乐
免费小说宝典	娱乐
时光小视频	娱乐
波波视频	娱乐
龙珠直播	娱乐
阅读王	娱乐
天翼阅读	娱乐
豆豆免费小说	娱乐
乐秀视频剪辑器	娱乐
快看漫画	娱乐
懒人听书-有声阅读电台	娱乐
斗鱼直播	娱乐
全民直播live	娱乐
免费小说全集	娱乐
齐齐直播	娱乐
内涵视频	娱乐
咪咕阅读	娱乐
一直播	娱乐
咪咕直播	娱乐
樊登读书会	娱乐
咪咕爱看	娱乐
小米直播助手	娱乐
锤子阅读	娱乐
手机电视直播	娱乐
免费小说大全	娱乐
战旗直播	娱乐
极品阅读	娱乐
小米视频	娱乐
多看阅读	娱乐
网易云阅读	娱乐
小影-短视频剪辑	娱乐
连尚读书	娱乐
爱看4G视频	娱乐
蛙趣视频	娱乐
秀色直播	娱乐
咪咕视频	娱乐
虎牙直播	娱乐
看点小视频	娱乐
和视频	娱乐
清闲手机电视高清直播	娱乐
直播吧	娱乐
和阅读	娱乐
三星阅读	娱乐
全本免费小说阅读器	娱乐
免费全本小说书城	娱乐
猫咪	娱乐
懒人听书	娱乐
懒人听书-有声小说电台	娱乐
懒人听书-有声图书馆	娱乐
全民K歌	娱乐
收音机	娱乐
节奏大师	娱乐
掌阅	娱乐
书旗小说	娱乐
蜻蜓FM	娱乐
熊猫看书	娱乐
企鹅FM	娱乐
抖音插件	娱乐
vivo文档阅读器	娱乐
QQ阅读	娱乐
Biu神器	娱乐
TalkBack	娱乐
K米	娱乐
掌阅iReader	娱乐
爱读掌阅	娱乐
i阅读	娱乐
爱阅读小说	娱乐
全民直播	娱乐
当当云阅读	娱乐
趣视频	娱乐
爱看4G	娱乐
秒拍视频	娱乐
京东阅读	娱乐
讯飞语记	娱乐
鸿雁传书	娱乐
逐浪小说	娱乐
AcFun	娱乐
笔趣阁	娱乐
掌中云小说	娱乐
蜜桃小说	娱乐
?懒人听书?	娱乐
七猫精品小说	娱乐
纵横小说	娱乐
个人图书馆	娱乐
小米AI	娱乐
今日头条	资讯
百度	资讯
今日头条极速版	资讯
趣头条	资讯
凤凰新闻	资讯
新闻	资讯
新闻资讯	资讯
锁屏新闻	资讯
今日十大新闻	资讯
网易新闻	资讯
资讯新闻	资讯
搜狐新闻三星版	资讯
搜狐新闻(资讯版)	资讯
好看图片新闻	资讯
浙江新闻	资讯
淘新闻	资讯
腾讯新闻	资讯
新浪新闻极速版	资讯
新闻聚合	资讯
搜狐新闻	资讯
头条视频	资讯
新浪新闻	资讯
一点资讯	资讯
天天快报	资讯
发现精彩	资讯
今日十大热点	资讯
知乎	资讯
界面新闻	资讯
澎湃新闻	资讯
淘最热点	资讯
微鲤头条	资讯
连尚头条	资讯
爱奇艺头条	资讯
美图文字秀秀	自拍
彩妆相机	自拍
泼辣修图	自拍
BeautyPlus	自拍
趣推	自拍
一闪	自拍
颜值测试	自拍
视频剪辑编辑大师	自拍
抠图大师	自拍
表情贴纸相机	自拍
活照片	自拍
美图秀秀	自拍
BeautyCam美颜相机	自拍
微视	自拍
VUE视频相机	自拍
乐秀视频编辑器	自拍
美图秀秀人像美容	自拍
视频编辑器	自拍
相机	自拍
视频编辑	自拍
照片	自拍
美颜相机	自拍
奇妙相机	自拍
花椒相机	自拍
相机360	自拍
黄油相机	自拍
黑咔相机	自拍
画中画相机	自拍
美妆相机	自拍
故事视频编辑器	自拍
美人相机	自拍
全能相机	自拍
视频制作-照片剪辑	自拍
无他相机	自拍
水印相机	自拍
微商水印相机	自拍
元道经纬相机	自拍
视频剪辑器	自拍
小影记-相册制作	自拍
动感相册	自拍
云相册	自拍
魔力相册	自拍
时光相册	自拍
潮自拍	自拍
秒拍	自拍
双重曝光	自拍
留声拍照	自拍
美拍	自拍
天天P图	自拍
超级微距	自拍
Faceu激萌	自拍
B612咔叽	自拍
PicsArt美易照片编辑	自拍
PicsArt照片编辑	自拍
秒拍视频	自拍
美图便签	自拍
B612	自拍
相机助手	自拍
360° 照片编辑器	自拍
CCTV微视	自拍
简影	自拍
美人妆	自拍
图片编辑器	自拍
图片加文字	自拍
录屏大师	自拍
屏幕录制	自拍
VSCO	自拍
录制屏幕	自拍
美图遥控器	自拍
语音美颜	自拍
绚彩夜拍	自拍